NO ./assets/textures/no.xpm
SO ./assets/textures/so.xpm
WE ./assets/textures/we.xpm
EA ./assets/textures/ea.xpm
F 220,10,8
C 225,30,0
1111111
1000001
1N00001
1000001
1000001
1111111