NO ./assets/textures/no.xpm
SO ./assets/textures/so.xpm
WE ./assets/textures/we.xpm
EA ./assets/textures/ea.xpm
F 220,10,8
C 225,30,0
1111111111111
1000000001001
1111000101001
1111010111101
1100001000101
11E000000g001
1111111111111