NO ./assets/textures/novalid.xpm
WE ./assets/textures/psoulie.xpm
SO ./assets/textures/vrey.xpm
EA ./assets/textures/atomasi.xpm

C 234,111,125
F 111,122,123

 111111
110E0001
11111C11
10000001
111O1111
11101
   1