NO ./assets/textures/no.xpm
EA ./assets/textures/ea.xpm

WE     ./assets/textures/we.xpm
                                      SO                           ./assets/textures/so.xpm


           F   102,51,0
C   150,195,212


111
1E1
1111
