                  NO ./assets/textures/no.xpm
EA ./assets/textures/ea.xpm
SO ./assets/textures/so.xpm

WE     ./assets/textures/we.xpm


           F   200,100,0
C   200,100,0
     1111111111111111111111111111111111
   1110000000000000000000000000000001111
1111000000000000000000000000000000111
10000000000000000000000000000000001
11110000000000000000000000000000001111
   1111110000000000000000000000000000111111
        10000000000000000000000000000000001
        10000000000000000000000000000000001
   1111110000000000000000000000000000111111
   10000000000000000000000000000000001
   100000000000000000000N0000000000001
   10000000000000000000000000000000001
   11111111111111111111111111111111111