NO ./assets/textures/no.xpm
EA ./assets/textures/ea.xpm

WE     ./assets/textures/we.xpm
                                      SO                           ./assets/textures/so.xpm


           F   200,100,0
C   200,100,0


      111111111111111111111111111111111
   1110000000000000000000000000000001111
1111000000000000000000000000000000111
10000000000000000000000000000000001
111111110000000000000111111110000001111
        10000000000000000000000000000001111
   1111110000000000000000000000000000111111
        10000000000001111111100000000000001
   1111110000000000000000000000000000111111
   10000000000000000000000000000000001
   100000000000000000000N0000000000001
   11111111111111111111111111111111111























