NO ./assets/textures/no.xpm
EA ./assets/textures/ea.xpm

WE     ./assets/textures/we.xpm
                                      SO                           ./assets/textures/so.xpm


           F   102,51,0
C   150,195,212


      111111111111111111111111111111111
   1110000000000000000000000000000001111
11110000000000000E0000100000000000111
10000000000000000000010000000000001
111111110000000000000111C11110000001111
        10000000000000000000000000000001111
   1111110000000000000000000000000000111111
        10000000000001111111100000000000001
   1111110000000000000000000000000000111111
   10000000000000000000000000000000001
   10000000000000000000000000000000001
   11111111111111111111111111111111111























